WWWWWWWWWWWWWWWWWWWWWWWWWWWWWWWWWWW
WFFFFFFFFFFFFFFFWWFFFWWFFFFFFFFFFFW
WFCFFFFKFFFFFFFFWWFDFWWFFFFKFFFFCFW
WFFFFFFFFFFFFFFFWWFFFWWFFFFFFFFFFFW
WFFFFFFFFFFFFFFFFFFFFFFFFFFFFFFFFFW
WFFFFFFFFFFFFFFFFFFBFFFFFFFFFFFFFFW
WFFFFFFFFFFFFFFFFFFFFFFFFFFFFFFFFFW
WFFFFFFFFFFFFFFFFFFFFFFFFFFFFFFFFFW
WWFFFWWWWWWWWWWWWWWWWWWWWWWWWWWWWWW
WFFFFFFFFFFFFFFFFFFFFFFFFFFFFFFFFFW
WFFFFFFFFFFFFFFFFFFFFFFFFFFFFFFFFFW
WFFFFFFFFFFFFFFFFFFFFFFFFFFFFFFFFFW
WFFFWWWWWWWWWWWWWWWWWWWWWWWWWWFFFFW
WFFFWFFFFFFFFFFFFFFFFFFFFFFFFFFFFFW
WFCFWFFFFKFFFFFFFFFFFFFFFFFFFFFFFFW
WWWWFFFFFFFFFFFFFFFFFFFFFFFFFFFFFFW
WFFFFFFFFFFFFWWWWWWWWWWWWWWWWWWWWWW
WFKFFFFFFFFFFFFFFFFFFFFFFFFFFFFFFFW
WFFFWWWFFFFFFFFFFFFFFFFFFFFFFFFFFFW
WFFFWCWFFFFFFFFFFFFFFFFFFFFFFFFFFFW
WWWWWWWWWWWWWWWWWWWWWWWWWWWWWWFFFFW
WFFFFFFFFFFFFFFFFFFFFFFFWFFFFFFFFFW
WCFFFFFFFFFFFFFFFFFFFFFFWFFFFFFFFFW
WFFFFFFFFFFFFFFFFFFFFFFFWFFFFFFFFFW
WWWWWWFFFWWWWWWWWWWWFFFFWFFFFFFFFFW
WFFFFFFFFWFFFFFFFFFFFFFFFFFFFFFWWWW
WFFFFFFFFWFFFFFFFFKFFFFFFFFFFFFWCWW
WFFFFFFPFWFFFFFFFFFFFFFFFFFFFFFWWWW
WWWWWWWWWWWWWWWWWWWWWWWWWWWWWWWWWWW
