WWWWWWWWWWWWWWWWWWWWWWWWWWWWWWWWWWW
WFFFFFFFFFFFFFFFWWFFFWWFFFFFFFFFFCW
WFFFFFFFFFFFFFFFWWFPFWWFFFFFFFFFFFW
WFFFFFFFFFFFFFFFWWFFFWWFFFFFFFFFFFW
WFFFWWWWWWWWWFFFFFFFFFFFFFFFFFFFFFW
WFFFWWWWWWWCWFFFFFFBFFFFFFFFFFFFFFW
WFFFWWWWWWWWWFFFFFFFFFFFFFFFFFFKFFW
WFFFWWWCWWWWWWWWWWWWWWWWWWWWWWWWWWW
WFFFWFFFFFFFFFFFFFFFFFFFFFFFFFWWCWW
WFFFWFFFFFFFFFFFFFFFFFFFFFFFFFWFFFW
WFFFFFFFFFFFFFFFFFFFFFFFFFFFFFWFFFW
WFFFFFFFFFFFFFFFFFFFFFFFFFFFFFWFFFW
WFFFFFFWWWWWWWWWWWWWWFFFFFFFFFWFFFW
WFFFFFFWFFKFFFFFFFFFWFFFFFFFFFWFFFW
WWWWWWWWFFFFFFFFFFFFFFFFFFFFFFWFFFW
WCFFFFFFFFFFFFFFFFFFFFFFFFFFFFWFFFW
WWWWWWFFFFFFFFFFFFFFFFFFFFFFFFWFFFW
WFFFFFFFFWWWWWWWFFFFWWWWWWWWWWWFFFW
WFDFFFFFFFFFWFFFFFFFFFFFFFFFFFWFFFW
WFFFFFFFFFFFWFFFFFFFFFFFFFFFFFWFFFW
WWWWWWWWWWWWWCFFFFFFFFFFFFFFFFWFFFW
WWWWWWWWWWWWWWWWWWWWWWWWWWFFFFWFFFW
WCFFFFFFFFFFFFFFFKFFFFFFFFFFFFWFFFW
WFFFFFFFFFFFFFFFFFFFFFFFFFFFFFWFFFW
WFFFFFFFFFFFFFFFFFFFFFFFFFFFFFWFFFW
WFFFFFFFFFFFFFFFFFFFFFFFFFFFFFFFFFW
WFFFFFFFFFFFFFFFFFFFFFFFFFFFFFFFFFW
WCFFFFFFFFFFFFFFFFFFFFFFFFFFFFFFFFW
WWWWWWWWWWWWWWWWWWWWWWWWWWWWWWWWWWW
