WWWWWWWWWWWWWWWWWWWWWWWWWWWWWWWWWWW
WFFFFFFFFFFFFFFFFFFFFFFFFFFFFFFFFKW
WKFFFFFFFFFFFFFFFFFFFFFFFFFFFFFFFFW
WFFFFFFFFFFFFFFFFFFFFFFFFFFFFFFFFFW
WFFFFFFFFFFFFFFFFFFFFFFFFFFFFFFFFFW
WWWWWWWFFFFWWWWWWWWWWWWWWWWWWFFFFFW
WFFFFFWFFFFWFFFFFFFFFFFFFFFKWFFFFFW
WFFFFFWFFFFWFFFFFFFFFFFFFFFFWFFFFFW
WFFFFFWFFFFWFFFFFFFFFFFFFFFFWFFFFFW
WFFFFFWFFFFWFFFFFFFFFFFFFFFFWFFFFFW
WFFFFFWFFFFWFFFFFFFFFFFFFFFFWFFFFFW
WFFFFFWFFFFWFFFFFWWWWWWWFFFFWFFFFFW
WFFFFFWFFFFWFFFFFWWFFFWWFFFFWFFFFFW
WFFFFFWFFFFWFFFFFWWFDFWWFFFFWFFFFFW
WFFFFFWFFFFWFFFFFWWFFFWWFFFFWFFFFFW
WFFFFFWFFFFWFFFFFFFFFFFWFFFFWFFFFFW
WFFFFFWFFFFWFFFFFFFFFFFWFFFFWFFFFFW
WFFFFFWFFFFWFFFFFFFFFFFWFFFFWFFFFFW
WFFPFFWFFFFWWWWWWWWWWWWWFFFFWFFFFFW
WFFFFFWFFFFFFFFFFFFFFFFFFFFFWFFFFFW
WFFFFFWFFFFFFFFFFFFFFFFFFFFFWFFFFFW
WFFFFFWFFFFFFFFFFFFFFFFFFFFFWFFFFFW
WFFFFFWWWWWWWWWWWWWWWWWWWWWWWFFFFFW
WFFFFFFFFFFFFFFFFFFFFFFFFFFFFFFFFFW
WFFFFFFFFFFFFFFFFFFFFFFFFFFFFFFFFFW
WFFFFFFFFFFFFFFFFFFFFFFFFFFFFFFFFFW
WFFFFFFFFFFFFFFFFFFFFFFFFFFFFFFFFFW
WKFFFFFFFFFFFFFFFFFFFFFFFFFFFFFFFKW
WWWWWWWWWWWWWWWWWWWWWWWWWWWWWWWWWWW
