WWWWWWWWWWWWWWWWWWWWWWWWWWWWWWWWWWW
WFFFFFFFFFFFFFFFFFFFFFFFKFFFFFFFFFW
WFFFCFFFFFFFFFFFFFFFFFFFFFFFFFFFFFW
WFFFFFFFFFFFFFFFFFFFFFFFFFFFFFFFFFW
WFFFFFFFFFFFFFFFFFFFFFFFFFFFFFFFFFW
WFFFFFFFFFFFFFFFFFFFFFFFFFFFFFFFFFW
WFFFFFCFFFFFFFFFFFFFFFFFFFFFFFFFFFW
WFFFFFFFFFFFFFFFFFFFFFFFFFFFFFFFFFW
WFFFWFFFFFFFFFFFFFFCFFFFFFFWWFFFFFW
WFFFWFFFKFFFFFFFFFFFFFFFFFFWWFFFFFW
WFFFWFFFFFFFFFFFWWWWWWWWFFFWWFFFFFW
WFFFWFFFFFFFFFCFWWWWWWWWFFFWWFFFFFW
WFFFWWWWWWWFFFFFWWWWWWWWFFFWWFFFFFW
WFFFFFFFFFFFFFFFWWFPFWWWFFFWWFFFFFW
WFFCFFFFFFFFFFFFWWFFFWWWFFFWWFFFFFW
WFFFFFFFFFFFFFFFWWFFFWWWFFFWWFFFFFW
WFFFFFFFFFFFFFFFWWFFFWWWFFFWWFFFFFW
WFFFFFFFFFFFFFFFWWFFFWWWFFFWWFFFFFW
WFFFFKFFFFFFFFFFWWFFFWWWFFFWWFFFFFW
WFFFFFFFFFCFFFFFWWFFFWWWFFFWWFFFFFW
WFFFCFFFFFFFFFFFWWFFFWWWFFFWWFFFFFW
WFFFFFFFFFFFFFFFWWFFFWWWFCFWWFFFFFW
WWWWWWWWWWWWWWWWWWFFFWWWWWWWWFFFFFW
WWWWWWWWWWWWWWWWWWFFFWWWWWWWWFFFFFW
WWWWWWWWWWWWWWWWWWFFFWWWWWWWWFFFFFW
WFFFFFFFFFFFFFFFFFFFFFFFFFFFFFFFFFW
WFDFFFFFFFFFFFFFFFFFFFFFFFFFFFFFFFW
WFFFFFFFFFFFFFFFFFFFFFFFFFFFFFFFFFW
WWWWWWWWWWWWWWWWWWWWWWWWWWWWWWWWWWW
