WWWWWWWWWWWWWWWWWWWWWWWWWWWWWWWWWWW
WFFFFWFFFFFWFFFFFFWFFFFFWFFFFWFFFFW
WFFFFWFFFFFWFFFFFFWFFFFFWFFFFWFFFFW
WFFFFWFFFFFWFFFFFFWFFFFFWFFFFWFFFFW
WWFFFWWFFFWWWFFFWWWWFFFWWWFFFWWFFFW
WFFFFWFFFFFWFFFFFFWFFFFFWFFFFWFFFFW
WFFFFWFFFFFWFFFFFFWFFFFFWFFFFWFFFFW
WFFFFWFFFFFWFFFFFFWFFDFFWFFFFWFFFFW
WFFFFWFFFFFWFFFFFFWFFFFFWFFFFWFFFFW
WFFFFWFFFFFWFFFFFFWFFFFFWFFFFWFFFFW
WFFFWWWFFFWWWWFFFWWWFFFWWFFFWWFFFWW
WFFFFWFFFFFWFFFFFFWFFFFFWFFFFWFFFFW
WFFFFWFFFFFWFFFFFFWFFFFFWFFFFWFFFFW
WFFFFWFFFFFWFFFFFFWFFFFFWFFFFWFFFFW
WFFFFWFFFFFWFFFFFFWFFFFFWFFFFWFFFFW
WFFFFWFFFFFWFFFFFFWFFFFFWFFFFWFFFFW
WWFFFWWFFFWWWFFFWWWWFFFWWWFFFWWFFFW
WFFFFWFFFFFWFFFFFFWFFFFFWFFFFWFFFFW
WFFFFWFFFFFWFFFFFFWFFFFFWFFFFWFFFFW
WFFFFWFFFFFWFFFFFFWFFFFFWFFFFWFFFFW
WFFFFWFFFFFWFFFFFFWFFFFFWFFFFWFFFFW
WFFFFWFFFFFWFFFFFFWFFFFFWFFFFWFFFFW
WFFFWWWFFFWWWWFFFWWWFFFWWFFFWWFFFWW
WFFFFWFFFFFFFFFFFFWFFFFFFFFFFWFFFFW
WFFFFWFFFFFFFFFFFFWFFFFFFFFFFWFFFFW
WFFPFFFFFFFFFFFFFFFFFFFFFFFFFFFFFFW
WFFFFFFFFFFWFFFFFFFFFFFFWFFFFFFFFFW
WFFFFFFFFFFWFFFFFFFFFFFFWFFFFFFFFFW
WWWWWWWWWWWWWWWWWWWWWWWWWWWWWWWWWWW
