WWWWWWWWWWWWWWWWWWWWWWWWWWWWWWWWWWW
WFFFFFFFFFFFFFWFFFFFFFFFFFFFWFFFFFW
WFFFFFFFFFFFFFWFFFFFFFFFFFFFWFFKFFW
WFFFFFFFFFFFFFWFFFFFFFFFFFFFWFFFFFW
WFFFFFFFFFFFFFWWWWWWFFFFFFFFWWFFFWW
WWWWWWWFFFFFFFWFFFFFFFFFFFFFFFFFFFW
WFFFFFFFFFFFFFFFFFFFFFFFFFFFFFFFFFW
WFFFFFFFFFFFFFFFFFFFFFFFFFFFFFFFFFW
WFFFFFFFFFFFFFFFFFFFFFFFFFFFFFFFFFW
WWWWWWWWWWWWWWFFFFFFFFFFFFFFFFFFFFW
WFFFFFFFFFFFFWFFFFFFFFFFFWWWWWWWWWW
WFFFFFFFFFFFFWFFFFFFFFFFFWFFFFFFFFW
WFFFFFFFFFFFFWFFFFFFFFFFFWFFFFFFFFW
WFFFWWWWWWWWWWFFFFFFFFFFFWFFFFCFFFW
WFFFFFFFFFFFFFFFFFFFFFFFFWFFFFFFFFW
WFFFFFFFFFFFFFFFFFFFFFFFFWFFFFFFFFW
WFFFFFFFFFFFFFFFFFFFFFFFFFFFFFFFFFW
WWWWWWWWWWWWWWWWWWWWWFFFFFFFFFFFFFW
WFFFFFFFFFFFFFFFFFFFFFFFFFFFFFFFFFW
WFFCFFFFFFFFFFFFFFFFFFFFFFFFFFFFFFW
WFFFFFFFFFFFFFFFFFFFFFFFFFFFFFFFFFW
WFFFFFFFFFFFFFFFFFFFWWWWWWWFFFFFFFW
WWWWWWWWWFFFFFFFFFFFFFFFFFWFFFBFFFW
WFFFFFFFFFFFFFFFFFFFFFFFFFWFFFFFFFW
WFFFPFFFFFFFFFFFFFFFFFFFFFWFFFDFFFW
WFFFFFFFFFFFFFFFFFFFFFFFFFWFFFFFFFW
WWWWWWWWWWWWWWWWWWWWWWWWWWWWWWWWWWW
